
SO textures/so.xpm
EA textures/no.xpm
WE textures/we.xpm 
NO textures/ea.xpm

C 0,0,0
F 109,0,0

111111
10N001
111111





