SO textures/so.xpm
EA textures/ea.xpm
WE textures/we.xpm 
NO textures/no.xpm 

F 109, 0, 0
C 0,0,0

111111
10N001
100001
100001
1000011
100001 1
111111





