
 SO     textures/so.xpm             
	NO textures/no.xpm
WE textures/we.xpm  
EA textures/ea.xpm
C 0,0,0

F 109, 11, 0   
                           1111111111
111111111111111111111111111111       1
10000000000000000000000000000111111111
1000000000000000001010001000011111
100000000000000001000000000001
10000000W00000000100000000000111111111
100000000000000000000001100001
100001110000000001000001100001
100000000000000001000000000001
111111111111111111111111111111

