SO textures/so.xpm
EA textures/ea.xpm
NO textures/no.xpm 
WE textures/we.xpm 

F 2, 0, 0
C 0,0,1

1111111111111111
1000000S00000001
1000000000000001
1111111111111101
1111111110000001
1000000000000001
1111111111111111





