
 SO     textures/so.xpm
	NO textures/no.xpm

WE textures/we.xpm
EA textures/ea.xpm
DOOR textures/door.xpm							

C 0,0,0
F 0, , 20

	11111111111111
		1001111111
11111111100111
10000000100001
10000000100001
10000000100001
10000000100001
10000000100001
10000000100001
10000000100001
10000000100001
10000000100001
10000000100001
10000000100001
10000000100001
1000000100001
10000000100001
10000000100001
10000000100001
10000000100001
10000000100001
10000000100001
10000000100001
10000000000001
10000000000001
10000000000001
10000000000001
10000000000001
10000000000001
10000000000001
10000000000001
10000000000001
10000000000001
10000000000001
10000000000001
10000000000001
10000001D10001
10000000000001
10000001D10001
10000000000001
10000000S01111
111111111111