
 SO     textures/so.xpm
			NO textures/no.xpm

WE textures/we.xpm 
EA textures/ea.xpm
DOOR textures/DOOR.xpm

C 0,0,0
F 109, 11, 214


111111111111
100001D0001
10000000001
10000000001
10000000N01
11111111111
