
 SO     textures/so.xpm
	NO textures/no.xpm

WE textures/we.xpm
EA textures/ea.xpm


DOOR textures/door.xpm							

C 0,0,0
F 0, 1, 9

1111111111111111
1000000E00000001
1000000000000001
11111111111D11D1
1111111110000001
1000000000000001
1111111111111111